3,0,0,0,0,0,2
0,5,5,5,5,5,0
0,5,0,2,0,5,0
0,5,0,0,0,5,0
0,5,0,4,0,5,0
0,5,0,0,0,5,0
1,5,5,5,5,5,0
0,0,0,0,0,0,3
salami,3
