1,0,5,4,5,0,0
4,2,5,4,5,0,0
0,0,5,5,5,0,0
0,0,5,4,5,0,0
0,0,5,5,5,0,0
0,0,5,4,5,0,0
0,0,0,0,0,3,3
0,0,0,0,0,0,1
cheese,1
salami,3
