1,0,4,4,4,2,0
0,0,0,0,0,0,0
0,0,0,0,0,0,0
3,3,0,2,0,0,4
0,0,0,0,0,0,0
0,0,0,0,0,0,0
0,0,0,0,0,0,0
0,2,0,0,0,0,1
cheese,1
salami,2
