0,0,0,0,0,0,0
0,5,0,0,0,0,0
0,0,0,0,0,5,0
0,0,5,0,0,0,0
0,0,0,3,2,0,5
5,0,1,3,3,0,0
0,0,0,0,0,0,0
0,0,0,0,5,0,0
cheese,4

