0,0,0,0,0,0,0
1,2,0,0,0,0,0
0,0,0,0,0,3,0
0,0,0,0,0,0,0
0,3,0,0,0,0,0
0,0,0,0,0,0,0
0,0,3,0,0,1,0
0,0,0,0,0,0,0
cheese,1
salami,2
