1,0,0,0,0,0,1
0,0,0,0,0,0,0
0,1,0,0,0,1,0
0,0,0,1,0,0,0
0,0,5,2,5,0,0
4,0,0,0,0,0,0
0,0,0,0,0,0,4
4,0,0,0,0,0,0
cheese,3
