0,0,0,0,0,0,0
0,0,0,0,0,0,0
0,0,0,0,0,0,0
0,0,0,0,0,0,0
0,0,2,0,0,0,0
0,0,0,1,1,0,0
0,0,0,0,0,0,0
0,0,0,0,0,0,0
cheese,10
salami,10
noodle,10
setaria,10
bomb,1
